111111111111111111
1000000000001000C1
1000111111001CC011
1C001000100C000010
100001E0000P100001
111111111111111111
