1111111111111
1E1000000C001
1010101111001
1010100010001
10000100000P1
1111111111111







