111111111111111111
1000000000001000C1
10001111C011
1C001000100C000011
10000110000P100001
1111111111111
